11111111111111111111111111111111
10000C00C000000000P0000000000001
1000001000100C000001110000000001
100000100010C000000C100000C00001
100000111110000000001000000C0001
1000001000100000000C100000000001
1000001000100C000001110000000C01
1000C0000000000000000000C000E001
11111111111111111111111111111111