111111111111111111111111111111111
10R0000000000C000000C000000000001
100001010010100000001001001001001
1000010100101000C0001001001001001
1000011111111P0000001001001001001
100001010010100000001001001C01001
100001010010100000001001001001001
1000000R00000000000000000000000E1
111111111111111111111111111111111